1111111111111
1001000E00001
1000011011001
100P0110C0001
1111111111111