11111111111
10M10E00C01
10000101001
10C00M01001
1000010R001
10M00C01001
100P0100001
11111111111