111111111111111111111111111111
1001000E0000000000000000000001
100001101111111111111111111001
100001101111111111111111111001
100001101111111111111111111001
100001101111111111111111111001
100P0110CCCCCCCCCCCCCCCCCC0001
111111111111111111111111111111