11111111111111111111111111111111
1EM000000M00MC00000C000000000001
10100101001000101001000MM0010101
10100100101010001001000000010101
10100100101010001001000000010101
10100100101010001001000000010101
10100100101010001001000000010101
10100100101010001001000000010101
10100100101010001001000000010101
10100100101010001001000000010101
10100100101010001001000000010101
10100100101010001001000000010101
10100100101010001001000000010101
10100100101010001001000000010101
10100100101010001001000000010101
10100100101010001001000000010101
1P0000M00C00C00000000000000000C1
11111111111111111111111111111111