1111111111111
1001000000001
1000011111001
1P0CE110000M1
1111111111111