11111111111111111111111111111111
100000C0000000000000C00000000001
101001010010001010C1000000111101
10000100101000001000000100010001
1010C001100010111001000000C10101
10100100101010E01001111100010001
11100010001010P01001000000010111
1010010000101110110110010001C001
100000001010000000C0010100010101
10100001001010011001000100010001
101001001000100000C0000100110001
1010010C001010001001000000000101
1C100100101010C00001001110010001
10100C00101000001001000000010101
100C0100101010C010000C0C00C00101
1010010010101000100100C000010101
1C000000000000000000001C01000001
11111111111111111111111111111111